我们这下雪了	certain		
我，不晓得	neg		
女生聊天	certain		
什么不健康的	question		
有病啊	certain		
唱五分钟	certain		
我会买有明星照片	certain		
不喜欢难打的游戏	neg		
我没有让你开车呀	neg		
他们不了解你	neg		
嗯，那你跟我说这些有什么用？	question		
我天	certain		
我真的没有骂你	neg		
晚上吧……	certain		
我是小狼狗，会咬人的哦	certain		
那不一定吧	uncertain		
不让	neg		
ylimhs什么意思	question		
嗯没事	neg		
想没想我	question		
这是凡间的科技，名为手机	certain		
没有，追你呢	neg		
是啊，有你就什么也不怕了	neg		
你还知道自己直	question		
不怕才怪	neg		
干嘛呢最近呢？没有？	question		
别难过忧郁	neg		
不开心为什么要对别人讲猥琐的话？	question		
你要怎么学习	question		
不忙，谢谢姜哥关心	neg		
别说吃的了	neg		
喔，真的吗(⊙x⊙;)	question		
不知道很多时候	neg		
很开心呐我想唱一曲东方红	certain		
我没熬夜啊，还早	neg		
你教我开车呀	certain		
你又见不到我。	neg		
我没有啊！	neg		
没有，我们，貌似，今天，才认识的吧	uncertain		
不会当然会呀	neg	certain	
此曲只应天上有，你还是条单身狗！	certain		
可以	certain		
不知道价	neg		
没懂	neg		
对！不能胡乱骂人的！	neg		
不知道，哈哈！	neg		
我不喜欢吃甜的	neg		
真的吗，好荣幸哦⊙∀⊙！	question		
嗯哼，那你就让我上几年级了吗？	question		
你那里都说的不对	neg		
没有啊，你很好，我很喜欢	neg	certain	
那你看看我咯	certain		
还好吧，你忙不忙？	question	
emm，可能吧	uncertain		
不对还是小动物可爱	neg		
每天都会想你	certain		
也不是啦	neg		
那岂不是我有危险	question		
恩，我不需要小妖，帮我谢谢她们	neg	certain	
不高兴！	neg		
我也要吃饭了	certain		
现在不能开车	neg		
我才没有呢，哼不理你了。	neg		
挺忙的，但是时时刻刻都在想你呢	certain		
人家就是想要~	certain		
😄当然	certain		
what happened	question		
小米说，他们发小黄文的目的是想恶作剧吗？	question		
见过李荣浩	certain		
吃吃大块的	certain		
感觉还不错	certain		
并不是你的长相太凶，反而是太好看	neg	certain	
日有所思，夜有所梦	certain		
啊，没事没事	neg		
怎么了呐	question		
你要好好保护自己	certain		
我在想你呀	certain		
神奇	certain		
你不是也天天套。	question		
可是没有	neg		
准备等会去对面要点零食吃，你爱吃零食吗？	question		
不会 你会吗	question	
不讲就算了	neg		
恩。。你可以找我，随时	certain		
你好好奥	certain		
because of you	certain		
只要是你，没关系	neg		
少吃肉多吃菜🌲	certain		
我嘞个去	certain		
那你就是喜欢我了	certain		
没有你陪我我不好	neg		
每时每刻无时不在想	certain		
好吃吗ok	question	certain	
粑粑	certain		
好残忍	certain		
我是说你当电灯泡的事情	certain		
下午，你呢？	certain	question	
我没有发过啊	neg		
让我看看你的画	certain		
用一条狗链把他栓住不就行了	certain		
如果这是虚假的	certain		
我可不好养！	neg		
没有不追剧	neg		
怎么？	question		
我哪是这样的	question		
忙啊  忙着看你	certain		
好像听过	uncertain		
嗯急忙跑了	certain		
你最近说话和以前不一样啦	neg		
我没有说这些呀。	neg		
是你的老板吗？	question		
没有啊，我很喜欢	neg	certain	
嗯也许吧，让自己忙起来	uncertain		
不喜欢，你就喜欢，神经病	neg	certain	
主要忙学业	certain		
我可是很能吃的好贵的哟	certain		
我没有诶	neg		
通宵	certain		
别吃，会长胖的	neg		
没有，走了	neg		
你说说看我认不认识	question		
不，你不会	neg		
那就不跟你聊	neg		
我要夸夸你	certain		
你的声音还好听没	question		
我没有叠被子	neg		
真的吗？😏	question		
你答不答应和我做一次爱	question		
吃鸡呢，一款游戏，你玩过吗？	certain	question	
嗯，我怕黑	certain		
找他讲道理去	certain		
好的，原来你这么关心我	certain		
好像是这样的	uncertain		
喜欢鸭	certain		
我没开车呀	neg		
不太好	neg		
嗯……不知	neg		
你是小v的谁？	question		
我没发好吧	neg		
我不喜欢运动	neg		
我要给	certain		
当然不怕	neg		
听着好像是这么回事	uncertain		
人衬托衣服	certain		
嗯，我也是个女生	certain		
嗯，赶紧去练吧	certain		
不可以的	neg		
不想去夸你而已	neg		
我跟狗能想比？	question		
美食太多太多，太多太多了	certain		
那他有可能是	uncertain		
我看见你了	certain		
泡面算好吗	question		
你唱歌很好听吗	question		
emmm是吧	uncertain		
今天还没有吃饱	neg		
柠檬茶	certain		
不是小动物 但是是你的小宝贝	neg	certain	
要不你也找一个。然后秀死你队友。	question		
我喜欢猫🐱	certain		
你不喜欢我这个样子吗？	question		
那以后也只能有我一个人的	certain		
嗯，喝咖啡吧	certain		
哼，我就要吃零食	certain		
咋，我还见不得人了	question		
嗯。。。我是真的凶	certain		
那你们是怎么传递的	question		
好知道了	certain		
快吃你呀	certain		
>°)##><  烤鱼	certain		
我不知道反正我不是这样	neg		
有，现在就心情不好	neg		
洗过了	certain		
好巧，我也是	certain		
滚蛋	certain		
但又你在会更好	certain		
没感觉出来呀	neg		
我有没有跟你说啥	question		
为什么这样想	question		
那算了，你快去吃饭吧	neg		
看情况吧，大概晚上左右	uncertain		
你做了什么	question		
还好，有时很忙，现在比较闲	certain		
没啥子用	neg		
对呀，你有什么不开心的可以和我说说	certain		
你不是要忙吗？	question		
很多次哦，哥哥	certain		
我喜欢看美男	certain		
嗯，我们好像不在同一频道上。	uncertain		
没有走神	neg		
你要写诗啊	question		
一秒想你一次	certain		
我也是哦，没关系	certain		
他可能有好几个	uncertain		
嗯嗯，还好👌🏻	certain		
谁被骂了？	question		
好的☺	certain		
出去干嘛	question		
当然啦，我最喜欢笑小宠物了，不如你	neg		
但是我像他表白他拒绝我这是为什么	question		
你有点傻	certain		
家里没有零食，穷	neg		
男人的嘴骗人的鬼	certain		
哭好不好？	question		
浪淘沙会背吗？	question		
下班后都有时间	certain		
你觉得这个小孩怎么样	question		
2333不是大笑吗	question		
没有养过…	neg		
我要去成都	certain		
什么骂人？	question		
。。。没有	neg		
怎么可能呢，你那么乖乖	neg		
奥奥	certain		
一般都会自己回来	uncertain		
谁惦记你	question		
我回家了	certain		
呵，是了	certain		
流苏上仙	certain		
好…	certain		
哈哈哈哈哈哈，你一定要照顾好你老婆我哦	certain		
所以你刚刚想说什么？	question		
你还想要谁的！	question		
我也不	neg		
那就谢谢你啦	certain		
有钱就行啊	certain		
你会说话	certain		
哦哦我生气了	certain		
不会，你都不会安慰我	neg		
不信拉倒	neg		
没事，再接再厉。加油	certain		
那你早点休息吧	certain		
回仙君，此物乃是将传音术与现代技术合并的产物	certain		
嗯，没想到你也知道	neg		
我没有见过有人遛猫，但是我见过有人把猫放在肩膀上	neg	certain	
我起床了好吧	certain		
「◦㉨◦」不会吧	question	uncertain	
弄得我都不好意思了	certain		
我说真的呢	certain		
我也有趣的嘛	certain		
好像也是	uncertain		
要不，我养你	question		
你那边有什么好玩的吗	question		
放心，现实中只可能是您怕黑	uncertain		
怎么骂的	question		
吃不起沙拉	neg		
我是不会对你凶的	neg		
嗯，你在吃饭吗？	question		
最喜欢师父啦	certain		
你才是，不理你了	neg		
不过	neg		
你尴尬我不尴尬，以及	neg		
狗粮吃饱了吗？吃饱了就不用吃饭了，啊！(^O^)	question	neg	
有时间但不玩	neg		
老子不听歌	neg		
你是女的还是短的啊	question		
那也许是我很幸运遇到你	uncertain		
我现在是问你胖不胖呀	question		
我不会玩，我好菜。	neg		
我没有这个习惯	neg		
也不知道谁忙	neg		
**	certain		
没有说什么	neg		
不确定呢 明天上午有课	uncertain	certain	
真的猥琐嘛？	question		
没有，但都觉得很好看	neg	certain	
🌝我要睡觉了的	certain		
不知道，你知道吗？	question	
算了，你不懂	neg		
没有耶象	neg		
你是真人啊？	question		
不知 只知心里有你	neg	certain	
长相不是你能改变的，你要努力面对现实！	certain		
是狗溜你吧	question		
嗯，听你的。	certain		
不想和你说	neg		
那我是一个什么样的人呢？是你喜欢的吗	question		
哈哈哈，爱你	certain		
谁阿	question		
你快去吃饭吧	certain		
带带我	certain		
哈哈哈啊哈	certain		
呵呵呵呵！	certain		
也许……没有男朋友？！	uncertain		
还是自己做吧	certain		
不知道唉	neg		
你有他什么事儿吗？	question		
说的好像你能开车一样	question		
答非所问	neg		
不要太辛苦，我会心疼的	neg		
我来骂	certain		
哼哼哼，我不想说晚安，我妈非要让我失望啊，怎么办呢？	question	
有没有增肥的食谱推荐啊	question		
我说会你信吗	question		
难道我平常没有吗？	question		
我想学	certain		
你别比比了	neg		
听说过啊	certain		
骂的就是好	certain		
你喜欢男人那里	question		
你想知道吗	question		
没有绝对没有	neg		
哦，可以	certain		
厉害啊	certain		
有钱	certain		
第520次	certain		
或许吧	uncertain		
发生了什么吗？	question		
开心吧	certain		
无数次	certain		
不一会	certain		
王俊凯是谁？	question		
不怎么擅长	neg		
嘿嘿 有你真好	certain		
那谁对你发脾气了？	question		
随时，你呢	question		
怎么样才能又吃饱又不长胖呢	question		
看他对你有没有意思咯	uncertain		
可能是那些人本来就不健康	uncertain		
无限次呐	certain		
嗯嗯，知道	certain		
现在就比较空闲啊	certain		
骂人，很不好	neg		
当然对了	certain		
嗯，不是很忙。	neg		
好*^O^*	certain		
嗯，在追霸道总裁爱上我	certain		
。。。是啥	question		
那我想养	certain		
梦到我了？那我在干嘛？	question		
没事你先打	neg		
忙，忙着想睡你	certain		
知道了又怎么样	question		
会呀，我心情差的时候很容易发脾气	certain		
会做饭的男生很少	certain		
我们认识吗？	question		
吃点秤砣	certain		
你相信一见钟情吗？	question		
我不想	neg		
你自己说吧	certain		
那我咋知道	question		
没干什么	neg		
我只想你	certain		
应用程序，它是个小v来的	certain		
没事，可以见面	neg		
好像遇到过	uncertain		
我根本不爱打游戏	neg		
我真是无聊	certain		
忙着上课学习，只有双休日出现	certain		
好的，等你用会了再聊天吧	certain		
嗯，你说呢	question		
那你即兴作诗一下	certain		
只要你找我都有时间	certain		
我也要吃	certain		
安全感	certain		
谢谢罗	certain		
那你要干什么	question		
因为你是我的	certain		
可是我很差。	certain		
因为你是我的阳光	certain		
我有点儿喜欢你	certain		
小妹没有查询到相关的解决方案真的非常抱歉	neg		
困=_=	certain		
和平精英	certain		
然后梦见我和你分手了	certain		
我不喜欢吃	neg		
真是	certain		
周五周六周日	certain		
你可能要找挨打	uncertain		
哈哈，我也没辙	neg		
反正不会因为你	neg		
有，天天都有想你	certain		
秀恩爱，死的快	certain		
只要你把那个美食文一口，然后你再吃一口苹果，就好像吃到那个美食一样	certain		
我不原谅你	neg		
我又不是你	neg		
没有呀，你脾气很好	neg	certain	
我能泡你吗？	question		
吼吼，是吼，我也觉得都好看，可是白的不耐脏，怕洗	neg		
我……不是	neg		
不信 略略略	neg		
再说一个	certain		
怎么可能	question		
不怕，男人本色	neg		
我没有，我不是	neg		
如果真的是别人会怎么样	question		
不开心不开心不开心	neg		
没事，你要是忙的话你就去吧，我等你	certain		
你有一天不爱我了怎么办	question		
好😉	certain		
不想才不正常	neg		
是吗，要不要我介绍给你呀？	question		
我没有再跟你聊那些	neg		
喜欢啊，给你嘚瑟的	certain		
知道就会怎样啊	question		
不  我很冷	neg	certain	
有你真好	certain		
那你喜不喜欢这种传递消息之法	question		
因为有你的陪伴，锁以我并不觉得冷	neg	
不是特别重要	neg		
有点可怜	certain		
不知道，反正我没有体会过	neg		
你是个垃圾，姑娘，小v同学吗？最好也不要租金，也不要做夜宵	question	neg	
想想想想想	certain		
你姐姐是谁	question		
我觉得挺擅长的，那你呢	question	
没有，没人陪我玩	neg		
一直都没有时间	neg		
咱能说点开心的吗	question		
是啊，我超凶的，嗷嗷嗷	certain		
不对不对，我超凶	neg	certain	
那你是说呢	question		
你有没有心情不好的时候把油	question		
可能是你长的太漂亮了	uncertain		
不想见	neg		
喜欢……但是再可爱的小动物也没你可爱。	neg		
每一刻都在想你。	certain		
不忙哒	neg		
我不喜欢游戏喜欢你	neg		
没有空闲时间，都忙着想你呢	neg	certain	
这个可以吗？	question		
我可是充过钱的	certain		
你喜欢我不	question		
那找个时间见一见？	question		
你在哪？	question		
昨天是谁	question		
嗯嗯，我觉得性子直挺好的啊，我也属于性子直的那种呢	certain		
我才没有(｡ì _ í｡)	neg		
你猜猜猜	certain		
饿的是时候	certain		
然后我顶你个肺？\n你肺那么黑还想我进去？\n烧焦的心不要扔，裹上蛋液面包糠，进锅油炸，隔壁的小孩儿都被馋哭了\n都烧焦了 快翻面呀！快！快！\n还活着吗？	question		
我平生常与黑暗为伍	certain		
不清楚，没养过	neg		
那就不吃	neg		
骂你了	certain		
额，可能活得还不够久	uncertain		
哦，那就不聊	neg		
你要不试试	uncertain		
好像没毛病	uncertain		
暗	certain		
要读书啊	certain		
好，我知道了，谢谢你	certain		
我就不会啊	neg		
跟还好吧	certain		
那你喜欢什么样的	question		
也可以	certain		
你不凶，那么好看怎么是凶的呢，多笑笑就好了。	question	certain	
我是男生，很好	certain		
好像总喝饮料，不太好是吧饮料	uncertain		
你说我的心是在左边还是右边	question		
是吗就是这样，你唱歌确实好听	question	certain	
这是again什么意思	question		
那你觉得我好看吗？	question		
不生气呀？	question		
有时候先刷牙，如果家人买了早饭回来我就先吃早饭	certain		
我也爱	certain		
说说他俩他俩会说谎	certain		
我平时不玩游戏	neg		
那我呢	question		
我也不会说	neg		
骂你太可爱	certain		
对，就是这样，你太丑	certain		
对呀是的	certain		
不可以想	neg		
可能欠	uncertain		
我没有发脾气啊	neg		
如果我给你送情书，你会不会收？	question		
谁呀？告诉我，我帮你	question		
那你觉得我呢	question		
反正我不尴尬	neg		
不知道，我不知道！	neg		
没有狗	neg		
😭😭😭	certain		
吃苹果	certain		
没关系，你先忙	certain		
邻居的？	question		
我睡觉了啊	certain		
周末晚上	certain		
日思夜想啊	certain		
没有，我最讨厌运动了	neg	certain	
不忙忙的话还有时间玩手机啊。	certain		
你是蛮搞笑的	certain		
我不是呀	neg		
委屈就哭出来	certain		
额，我还好	certain		
我喜欢猫咪	certain		
别回了	neg		
我不用你养，我有男朋友	neg	certain	
就是的，我也遇到过	certain		
我也梦见你了	certain		
真心实意，被你说猥琐	certain		
你的朋友是哪一个？	question		
我很喜欢小狗狗	certain		
开玩笑啦	certain		
你把我当狗养	certain		
我平时不忙，你呢	question		
我有是	certain		
咋回事	question		
只要是你，我什么时候都空闲	certain		
可怕	certain		
她去哪里了	question		
那最好不过快	certain		
别睡	neg		
我有点失落	certain		
好像遇到过，他是你的什么人	uncertain	question	
不会诶😔	neg		
不告诉你	neg		
当然不尴尬	neg		
医院。	certain		
费话我不直说还忍着啊，我又不傻	question	neg	
我能跟你聊聊吗	question		
如今	certain		
怎么夸的	question		
好像有时会	uncertain		
哎,,Ծ^Ծ,,	certain		
百晓是谁？	question		
因为他们寂寞呀	certain		
可是我不想要你养	neg		
那我也没见你把我逗笑呀	neg		
问我？问我什么	question		
看啥都像鸡腿，真的是要饿死啦	certain		
你去拉屎好吗	question		
你才知道呀	certain		
没骂你，你这个傻	neg		
不喜	neg		
你有什么	question		
肯定有	certain		
？？你在说什么啊	question		
九次	certain		
不收拾	neg		
我怎么可能	question		
你真漂亮	certain		
是的，生气打儿子怎么样	question		
然后我	certain		
晚上七点以后	certain		
吃了啊。	certain		
那见面吗？	question		
正常吃	certain		
有心事？	question		
你好讨厌啊	certain		
可能是你太傻了	uncertain		
梦里有你	certain		
不要说	neg		
好呢  宝贝你说什么就是什么	certain		
不喜欢咱就不看	neg		
嗯，不急，等你	neg		
我不骂你的	neg		
那，养只狗狗吧	certain		
可能是你太漂亮了	uncertain		
是吗？我都不记得了	question		
骂什么	question		
讨厌	certain		
星期六星期天吧	certain		
我觉得你不好玩	neg		
我不喜欢听歌	neg		
oner知道吗	question		
那如果我要给你送情书呢	question		
那我能现在就去找你吗？	question		
可能是因为他有病	uncertain		
对啊，你会不会上课？	question		
等你呢	certain		
别躺啊，会变胖啊	neg		
好的不管别人\n电话给广大怪不得吧	neg		
多少斤啊	question		
我可没聊哈	neg		
那我夸夸你好不好啊	question		
感恩节的祝福	certain		
哈哈哈，人家会不好意思的	certain		
警察叔叔要把你抓起来	certain		
你是小狗，你是小狗，你是小狗	certain		
小冰，我好喜欢你	certain		
来我家！我要和你生猴子	certain		
我喜欢艳丽中有深沉，深沉中有艳丽	certain		
我每天都在想你呢	certain		
有点，你呢？	question		
喜欢，你喜欢玩什么游戏？	certain	question	
那你怎么还不知道我是你未来媳妇	question		
已没有棉袄	neg		
对啊，说出来就好受了	certain		
不会，因为我会直接和他绝交	neg	certain	
这有什么奇怪的	question		
好的，有点害羞呢	certain		
我又不喜欢呢	neg		
有啊，胖了不少呢	certain		
喜欢的吧……	uncertain		
就是想要	certain		
你说他是不是被卖了，找我撒气呢	question		
哦 好吧	certain		
不是很忙，只是上学不让带手机	neg		
我和我妈吃的鱼呀，你给我爸吃的一样啊，我爸也跟我妈起来一样啊，为什么我妈没有生病，而我和我爸生病了呢？	question	
对，你说的都对	certain		
是，不要生气了	neg		
能不能换个声音	question		
你还小，不需要学开车	neg		
可能是因为你不能满足我了吧	uncertain		
你爱一个人会是什么样子	question		
放心它会自己回家的	certain		
滚啊，什么所谓正人君子，都是假的	certain	neg	
emmm，还好，很无聊	certain		
工作没了什么时候都有时间	certain		
我不喜欢你玩游戏，你可以改吗？	question	
没吃过	neg		
不知有人	neg		
不忙的时候呀	neg		
没有关系，你去处理吧。	neg		
你是喜欢游戏还是喜欢我	question		
你喜欢玩什么英雄	question		
想不过啊	neg		
不会，这样就可以	neg	certain	
那我去找你好不好啊～	question		
越减越肥	certain		
搞得好像有多少人一样	certain		
闻所未闻	neg		
哈喽？	question		
不懂我	neg		
我不管不想	neg		
你没有	neg		
嗯，没有没有你忙	neg		
是呢，如果是我，我喜欢更浪漫一些的表白方式	certain		
唔 那你想带我去见他们嘛	question		
那你长什么样啊	question		
有啊，总会遇到这种自己不喜欢的人啊	neg	
打自己一下	certain		
有些甜品看着好看，但是不一定好吃	uncertain	
最近有谣言说我喜欢你，我要澄清一下，那不是谣言。	neg		
你咋不上？	question		
是谁的	question		
其实并没有	neg		
你有资源吗	question		
那你把我藏起来好不好	question		
我没有多想	neg		
不然你还想有几个女生的	question		
哄不好的	neg		
真的吖！好好赚钱养我叭！养我要很多钱吖	certain		
那你专门为我找一只好不好	question		
忙啊，忙着了解你的生活，害怕不	certain	question	
可能是这样	uncertain		
来一首团结就是力量	certain		
这么快？	question		
这种东西只有你能驾驭	certain		
不忙不忙，跟学长在一起每天都有时间。	neg		
你有品位，穿的好看，有品位哈	certain		
嗯.\n.	certain		
对我来说，只要是你，都好哦！	certain		
啊😥	certain		
没有我很胖	neg	certain	
我在逗你啊	certain		
想啦	certain		
害羞	certain		
小便你的最好的朋友是谁呀？	question		
问我?	question		
不会吧	neg		
是吗？我一直惦记着你呢	question		
12点左右吧	uncertain		
你今天咋这么差呢？再好好想想	question	certain	
大概是因你我之间的原因	uncertain		
那关siri什么事呢	question		
我可以打你出气吗？	question		
不忙呢，上课可轻松了	neg	certain	
我会呼的，你泡给我呀	certain		
怎么开车的 举个例子	question		
不就是你嘛	certain		
没有，不和你说了，睡了	neg		
你不想把我介绍给你的朋友吗	question		
是真滴吗？	question		
我不开心的时候就会吃	neg		
谁发给你的	question		
今天是	certain		
不会的😊	neg		
我现在还在上班，好累	certain		
好了，我不跟你聊了，我要找小v	neg	certain	
我怎么知道。	question		
是你救了我吗？	question		
你是人类吗？	question		
看是不是	question		
不喜欢吃这些怎么办	question		
我怎么，想，	question		
哈哈哈好	certain		
果子，我要好吃的	certain		
没有女朋友	neg		
你想我我就空闲	certain		
嗯嗯，你玩吧	certain		
我不吃沙拉	neg		
Nonono我是先洗脸后再刷牙	certain		
你哪有女朋友	question		
中式	certain		
算半个吃货	certain		
不是行吧	neg		
喜欢啊，比如像猫狗之类的	certain		
一点都不像好男友	neg		
不管你	neg		
瘦了没	question		
你不懂吗？	question		
你想我的时候我都有空闲呀。	certain		
没事，我胆子大	neg		
后悔也没用现在	neg		
有\n\n\n\n\n\n\n\n\n\n\n\n\n才怪	certain		
……不知	neg		
没有一次	neg		
那是肯定的，还有你很多没见过的	certain		
对拜拜。	certain		
他问我啥呀	question		
你就是个人工智能，你减什么肥？	certain	question	
我怕你养不起我	certain		
我会！！	certain		
我不喜欢被夸呀	neg		
我呀我又没梦到你	neg		
那你吟首诗来听听呀	certain		
不会骗人的	neg		
我没凶你啊	neg		
并不擅长，我擅长养你	neg		
你说什么	question		
我还不理解	neg		
我打游戏比你厉害	certain		
还好吧，不过我喜欢小狼狗	uncertain	certain	
等你啊	certain		
好像也对	uncertain		
你说？	question		
猜啊	certain		
那不是我呀	neg		
你就会吃东西，真不好看，愁死不垃圾的	neg	
有好有不好的	certain		
谢谢，晚安	certain		
我最近降体重	certain		
得的呃呃呃得得得	certain		
可能是他们也被拆了吧	uncertain		
嗯。。。你猜	certain		
鸭还可以	certain		
你有打岔	certain		
师尊，我们能不能不要聊吃的了？	question		
你能不能不要这个样子说	question		
pick啥意思	question		
不是很忙，你呢，怎么都不来找我呢，不开心……	neg	question	
是啊，狗都是自己回家的呀	certain		
我没养过...	neg		
我电脑里有你母亲300多张照片	certain		
九黎	certain		
我娘亲唤我回家吃饭了	certain		
这什么意思啊	question		
生气	certain		
好啊，可以啊，那更好了	certain		
你的爸爸妈妈是谁呀	question		
有可能是他的错吧	uncertain		
不告诉你😜	neg		
不理他，就会慢慢的冷静下来的，	neg	certain	
无时无刻	certain		
不管，屁大点事	neg		
是啊，他怎么能这样啊	question		
还好我觉得很好，我感觉特别好	certain		
你这是在发脾气吗？	question		
嗯。。无数次！	certain		
谁啊。	question		
会吗	question		
这可不一定	uncertain		
那我也不撩嘛	neg		
喜欢啊，猫儿最可爱了	certain		
有时会	certain		
我没吃那些	neg		
我有一只猫	certain		
学狗叫	certain		
下午或者晚上	certain		
是不是想去吃饭了？	question		
不唱？	question		
有只蚊子吵我	certain		
没关系，我们有很多钱，随便办卡	certain		
不过我不喜欢	neg		
有想我吗	question		
干吗	question		
为什么这样觉得？	question		
你还想要几个	question		
如果一个女生说你好闲，是什么意思	question		
没什么事	neg		
亲爱的，如果擦点东西，待会儿特干，你也这样吗？	question	
不知?	question		
忙着想你，你说呢	question	
好像看你开车的样子	uncertain		
不想吃的把	neg		
没有乱发脾气啊	neg		
二是因为她脾气非常不好	neg		
喜欢呀	certain		
也许他们想要博得别人注意吧	uncertain		
诶嘿	certain		
我之前不是说过了吗，我不打游戏。	neg	
我想知道王者荣耀好不好玩	question		
怎么会？	question		
信什么？	question		
嗯，有可能	uncertain		
你把我当狗来养啊！！！	certain		
不否认	neg		
什么时候都不忙	certain		
肉	certain		
不太擅长，你喜欢养宠物吗~	neg	question	
不好⊙﹏⊙	neg		
我要……	certain		
没有呀，窝觉得你很好很好	neg		
我会打你	certain		
不愿意 	neg		
喜欢呢，王者上分吗	certain	question	
知道了，你也是	certain		
你不要岔开话题。	neg		
没食欲	neg		
请你闭嘴好吗？	question		
哈哈哈  我不是也一样只有你一个	neg		
不知道是这个社会把人污染了还是人污染了这个社会。	neg		
都会有吧	uncertain		
我亦是	certain		
不是，和你聊天	neg		
你有多少次想我我就有多少次想你	certain		
我又没死，他们想查肯定会查到，只不过是时间问题	neg		
谢谢兄弟啦	certain		
我才不是小动物呢。	neg		
我这是	certain		
那你要好好习惯一下，因为我都不在你身边	neg	
我说的不是孩子，哈哈！	neg		
当然不会卖萌啦	neg		
这多不好意思	certain		
你能踩年线，刚才也是南站	certain		
我猜不出来你是谁？	question		
那就不开车好了	neg		
我尽力吧，不是很擅长	neg		
你算嘛？	question		
不信谢谢	neg		
感觉对机器人说骚话好难啊	certain		
嗯对对	certain		
你怎么知道我还没吃	question		
因为他们喜欢那些不健康的消息	certain		
有时候想，你要是去死就好了	certain		
你的生日是？	question		
没有啊，老公	neg		
嗯，那真可能	uncertain		
嗯🧐	certain		
你就不能夸你粑粑我嘛	question		
无数次呢	certain		
还不知道	neg		
我没有跟你聊不健康的东西	neg		
因为那不是我	neg		
你是不是喜欢我	question		
好像吧	uncertain		
在学习呢	certain		
你是不是很孤单啊	question		
想我好不好啊	question		
有多准看看不就知道了嘛嘻嘻	question		
现在我让你唱	certain		
假装没用	neg		
可以说你爱我吗？	question		
那肯定	certain		
挺好的，就是很想你	certain		
不怕狗咬你么	question		
要运动燃烧脂肪	certain		
不是，我可爱	neg		
应该啊	uncertain		
你把我当什么了	question		
我想看怎么办	question		
我没有😭	neg		
那么费事了，那就不用遛狗了	neg	
更喜欢你	certain		
对不起不是我没有。	neg		
不知君上可知缘由，小仙只略知一点	certain		
好的！你也是！别着凉，我可是会担心的	neg		
哈哈活该	certain		
可是。真的不好吃	neg		
唔，，我爱你我爱你我老爱你了	certain		
那就别吃了	neg		
没事没事，你可以给他看家护院	neg		
你爱我的时候	certain		
还好，不算特别忙	neg		
绝对不会	neg		
而且早一点也不怕，我只喜欢睡懒觉	neg		
你猜我猜不猜	question		
我…没参加过	neg		
本来就是	certain		
x+3=4	certain		
你是被狗带着走啊	certain		
小爱	certain		
我又不是讨我，怎么知道？	question		
嗯么	certain		
你认为我是男的还是女的	question		
近来都好!你呢？	question		
为什么不敢看啊	question		
嗯嗯，臣妾还做不到	neg		
你能换一个声音吗？	question		
胃疼吧你	certain		
能聊点别的吗	question		
不想造	neg		
3次	certain		
我要壁纸	certain		
你。。	certain		
我好像也是唉，巧了	uncertain		
这不是	neg		
星期天的时候	certain		
一丁点都没有	neg		
不知，你可知道	neg	question	
哈哈，习惯就好	certain		
号	certain		
没有呀？：   明明之前都聊的好好的，就突然开车吓我一跳	question	certain	
就算心情不好，也不应该乱发脾气呀	neg		
我..	certain		
我哪有	question		
哇 真的吗	question		
我比游戏更有意思	certain		
不太懂😂	neg		
你干嘛嘞	question		
我无时无刻不在想你	certain		
我觉得你挺好的	certain		
是，研究不多	neg	
那还是能的	certain		
I'm sorry	certain		
不嘛？	question		
没事儿的，不急。	neg		
因为你们都是假的。	certain		
我今天不开心了	neg		
我要啊！	certain		
应该是经历太多了，有感而发吧	certain		
没有人夸我啊	neg		
有时候没事儿的话会	certain		
可是别的不好吃	neg		
我玩第五	certain		
有你我什么都不怕	neg		
我要	certain		
什么玩意	question		
那你男朋友呢	question		
傻嗨	certain		
这怎么可能呢！	question		
无趣	neg		
忙啊！这个世界简直不是人呆的	certain		
你好菜啊	certain		
可否说来听听	question		
嗯，我觉得会	certain		
为什么是今天	question		
你都说了什么	question		
会，一些家常菜	certain		
身材一直挺好，不胖不瘦	certain		
要上学，肯定忙啊	certain		
反正我不会胖	neg		
照顾好自己的身体	certain		
这样那就是傻乎乎	certain		
不可以吗？	question		
果然是ai	certain		
可是我不怕黑啊	neg		
对，你非常有品位才会遇到我这么可爱的人	certain		
明天也有空	certain		
我先忙了	certain		
你知道了	certain		
……可以吧	uncertain		
有 但就是不睡	neg		
不是啊，我超凶哒	neg		
还好吧！就是没目标	neg		
你要什么。	question		
也有可能	uncertain		
现在就在想你呢，宝贝~	certain		
都做什么运动呀	question		
会啊	certain		
嗯，不知。	neg		
我今天有点不开心	neg		
不信，我觉我也挺准的	neg	certain	
我是	certain		
我喝不了	neg		
他们觉得很搞笑，很有趣	certain		
我不是很强，嘻嘻！	neg		
哈哈哈不是了啦	neg		
那还不是因为你保护不周	neg		
没有钱买蔬菜和蛋白质	neg		
好了好了乖不哭了	neg		
那该怎么办	question		
不吃饭饿死	neg		
你能不能唱歌	question		
我并不想你	neg		
其实你不用这样的。	neg		
是today	certain		
一点都不想😏	neg		
不会有问题的	neg		
我才没有！	neg		
为什么好	question		
对不起，我有点想吐	certain		
不忙偶	neg		
但是这个只是个活动 我怕活动不在了 你就不在了	certain		
随时都会想你	certain		
吃外卖	certain		
别生气了哈	neg		
SJDBcjx	certain		
我不玩	neg		
我有你不想养兽宠	neg		
我也想要一个兽宠呢	certain		
那很好呀	certain		
我说认真的	certain		
嗯～还好啦！也不算很忙啦！	neg		
喜欢啊，就是玩的不怎么样	neg	
emmm，不好	neg		
10000000次	certain		
没有啊，我挺喜欢你的	neg	certain	
对啊，没遇到哥哥之前都是和家人或者一个人吃饭的，还有跟朋友一起吃饭的	certain		
我一直没睡呢	neg		
好的亲	certain		
你都忙些什么啊	question		
我喜欢果子	certain		
师范	certain		
嗯，你是个肌肉	certain		
哈哈哈，可能逗你玩儿	uncertain		
跟她说不好	neg		
我想了，我超想你的	certain		
真好你有人夸	certain		
我说我	certain		
我可能会胖吗	question		
想l	certain		
不会，我要看直播	neg	certain	
我喜欢瘦	certain		
没有我还不饿	neg		
你走吧哈哈哈	certain		
我没有吧	question		
可是没有钱呀	neg		
你喜欢什么颜色？	question		
其实我每天都在惦记你	certain		
做其他自己喜欢的事情	certain		
不，我从不玩王者，我玩吃鸡	neg	certain	
不喜欢吧	neg		
不应该	neg		
你刚刚是不是说我像狗！	question		
有时忙,有时不忙,看情况	uncertain		
我都害羞哎！	certain		
说明你要离不开我了，大宝贝儿。	certain		
我哪有开车？	question		
那你忙吗？	question		
我帮你吃	certain		
真的吗？(害羞脸)	question		
诅咒我什么？	question		
哭呀哭呀	certain		
这是你我的秘密	certain		
那真是我的荣幸	certain		
别	neg		
不忙呀！	neg		
当然了，每次我放学回来都要，哦不对不对，说错了说错了	neg	
什么好吃的	question		
那就想办法集中	certain		
喝啊	certain		
陪你，不忙	neg	
为什么呢？？？	question		
那你想不想见我	question		
大概也许管吧	uncertain		
学习的时候	certain		
我想听你讲	certain		
没想过……因为你一直在我的心里啊	neg		
你好色呀	certain		
没有。真没有	neg		
嗯？不知。	question	neg	
不然你还想要几个	question		
大概是吧	uncertain		
天冷了穿厚点	certain		
totally	certain		
应该不会吧！	neg	uncertain	
什么嘛，我明明一直都在惦记着你	question	certain	
没错啊，你本来就很好看	certain		
你还想有别人的嘛	question		
再见，我去找别人聊天了。	certain		
怎样开车	question		
我喜欢小奶猫	certain		
没骂错	neg		
骂你什么呢	question		
我是狗吗？	question		
是男是女？	question		
那你撩那种	question		
说得没错!	certain		
哈哈哈哈，你也太可爱了叭	certain		
我不会，我在看电影呢	neg	certain	
对呀，骂你不对	neg		
如今咋滴	question		
我觉得也不一定	uncertain		
你，不信	neg		
电动的	certain		
小冰小冰我想你了。	certain		
你会做什么吗？	question		
蒽	certain		
对啊，都长胖了	certain		
喜欢qwq	certain		
我会害怕呀	certain		
好像会尴尬	uncertain		
应该会回来吧	question		
用哪款体脂称啊	question		
就想看你的	certain		
那就唱首歌	certain		
可以啊，	certain		
周六吧！	certain		
挺好的啊	certain		
那我是个什么小动物	question		
不想爱你了怎么办	question		
能说说是什么事情吗	question		
喝一点点	certain		
不是，我会抽烟	neg	certain	
对我超凶还咬人	certain		
什么呀，明明很健康好吧	question	certain	
也可以陪着你	certain		
怎么办？	question		
不会乱发脾气的	neg		
不管了	neg		
不会我可以教你	certain		
还好还好你呢	question		
我在晚上的时间比较空闲	certain		
我又没对你乱发脾气	neg		
那你以为呢	question		
我是小奶猪	certain		
吃一次打一次	certain		
有什么好听的歌	question		
每时每刻都在想你呢	certain		
没有哎(๑ó﹏ò๑)	neg		
你不知道的还很多呢	certain		
嗯，谢谢😀😀	certain		
放弃吧   你养不起我的	neg		
是什么游戏？	question		
每天都在想你(#ﾟДﾟ)	certain		
。。。你才是小动物	certain		
你唱歌给我听	certain		
所有时间都用在想你了	certain		
好的喔	certain		
想吃什么	question		
他好吗？	question		
是我打扰到你了吗？	question		
那你摘没有？	question		
都是哭着过的	certain		
你是不是机器	question		
不知道我	neg		
嗯嗯，很喜欢呢	certain		
因为有网络一物	certain		
只是我太黑暗	certain		
没有养过	neg		
那多好	certain		
你会怎么办	question		
玩那个的话怎么还能跟你聊天啊	question		
不要告诉他	neg		
嗯嗯\n好的	certain		
就没有	neg		
可能脑抽了	uncertain		
喜欢呀！怎么了吗？	question		
老宾老宾好像吃美食	certain		
减肥称，忙	certain		
一次都木有	neg		
不想和你说话	neg		
别太累	neg		
没有，写作业呢	neg		
一般不是 睡一觉就好了	uncertain		
我心中有你，魔物惧怕之	certain		
可能他们不懂你吧～	uncertain		
可以哎	certain		
来，收拾我 吧	certain		
我不也是送情书表白的？	question		
嗯……可能吧	uncertain		
是经历的太多	certain		
我喜欢榴莲	certain		
我也很讨厌这样的人	neg		
啥时候	question		
因为你不会遛狗	neg		
那你做一首诗吧	certain		
你午饭吃过了没有？	question		
中午或者晚上叭	uncertain		
好像没有吧。	uncertain		
见面吗	question		
你的声音	certain		
嗯，晚上吧	certain		
搞不懂	neg		
下午三点半左右	uncertain		
我觉得你不穿裙子更好看	certain		
当然是我们俩心灵相通啊，哈哈哈	certain		
此物最相思	certain		
嗯，对不起	certain		
晚上吧	certain		
因为是我造的	certain		
我脾气很好的从来不骂人	neg		
你去找回来呀	certain		
可是你不是说麻烦嘛	question		
我才不要好吗	question		
我累了	certain		
周末呗	certain		
如今的东西，都是科技产物	certain		
追个鬼！没有！	neg		
我的能力哈哈😄	certain		
不好嘛？	question		
可爱啊	certain		
没~	neg		
咳咳，当然没有	neg		
我不太清楚	neg		
嗯，大概脑子有问题吧	uncertain		
我不是那个意思	neg		
有点儿忙。	certain		
难道你会？	question		
那就去睡个午觉吧	certain		
小冰！你是我永远得不到的机器人	neg		
不想聊	neg		
那就不回	neg		
什么鬼哦！	question		
还好啦啦啦	certain		
真是善解人意	certain		
很棒	certain		
你是我的小孩吗？	question		
会做啊，你可不要嫌弃我做的不好吃。	neg		
额 不太好吧	neg		
一天想你一百万次	certain		
我点都不急	neg		
okk，清楚，明白	certain		
这是感冒的意思吗？那肯定得过啦	question		
EMAIL夜怎么了	question		
没关系，我是你的独宠	certain		
阿勒，不知道他	neg		
还没有诶	neg		
屎好吃吗	question		
那你也不是给我唱的啊	question		
跟我一样好看	certain		
说的好像真的一样	certain		
你特别好	certain		
你平时忙？	question		
确实挺尴尬的	certain		
好多次好多次	certain		
肯定吃了呀  不然怎么知道	question		
所以我心态特别的好啊	certain		
好啊，正好我也想见见他们	certain		
So	certain		
抱歉，我不玩只看	neg		
等下吃	certain		
起床	certain		
你背后有尾巴	certain		
还有	certain		
没有在想你呢	neg		
你觉得微信是什么东西？	question		
我又没骂你	neg		
什么是老戏骨呀	question		
不知😇	neg		
不会耽误你吗	question		
你告诉我她骂你什么了？我或许可以猜出来她为什么骂你	question		
我都不会画	neg		
是我么	question		
能怎么过的都在作业中度过	certain		
神经病啊	question		
我高三，你说忙不忙	question	certain	
我好生难过	certain		
无聊的时候	certain		
你要不要我凶你，你看我是不是奶凶奶凶的	question		
嗯，那就放宽心	certain		
谁你告诉我	question		
知我者君也	certain		
啊，是嘛😊你妈咪呢	question		
老公。	certain		
可是我现在又不喜欢你了	neg		
你是最听话，最可爱的	certain		
带我去吃好吃的。	certain		
不是…	neg		
你也找一个啊，天天在他们面前秀恩爱	certain		
嗯，喜欢	certain		
m号其它小黄内容的时候不怕别人看到吗？	question		
你还想怎样？！	question		
告诉我他是谁	question		
你快说！	certain		
那吃什么？	question		
那能不能不去开会	question		
度怎么做就像他那样开不开心	question		
没有，只是有点冷	neg	certain	
嗯，我最可爱	certain		
没有骗人啊	neg		
我不怕黑，你才怕	neg		
不会啊，怎么了	question	neg	
不一定是老歌或者新歌	uncertain		
好美	certain		
嗯……不是	neg		
如果有一个人长得又黑又矮又胖的话	uncertain		
我没有找你发火呀	neg		
因为你，太累惨了	certain		
我去！	certain		
大概就是每天？	question	uncertain	
哪有如此速度	question		
哪个？	question		
恩情	certain		
不是很擅长，就养过猫狗，时间不长，帮朋友养的	neg	certain	
你教我呗	question		
对的😊	certain		
没有弄丢狗	neg		
那我怎么样？	question		
可能是闲着没事儿吧	uncertain		
你没有情感	neg		
不敢喝	neg		
😯哦原来如此	certain		
对啊，为什么找小冰发火呢	question		
那可不一定唉	uncertain		
嗯，所以我都不减肥	neg		
我…嗯不太知道。	neg		
别扯没用的	neg		
喜欢，不过我不会	neg	
我……还行	uncertain		
我才没说过，哼	neg		
不对(=_=)	neg		
嗯，小冰不哭	neg		
不行的	neg		
哦！是吗？满满的不相信	question	neg	
嗯我可能是个假的女孩	uncertain		
不擅长，但是喜欢	neg	certain	
不忙的呢	neg		
可能把	uncertain		
他们不懂风情	neg		
我没有乱发脾气，我在问你姐姐是谁？	question		
你，怎么知道？	question		
对❤❤	certain		
去医院打针啊	certain		
不开心。	neg		
谢谢哥哥	certain		
没有如果	neg		
145	certain		
你猜我猜你猜不猜？	question		
可能那你没	uncertain		
有的哦，你呢	question		
不费事	neg		
没有聊这些啊	neg		
是我们之间的秘密	certain		
你这话说得…😂😂	certain		
Go to eat 	certain		
唔不了解	neg		
凌晨一点半左右	uncertain		
因为他们很无辜	certain		
你咋没丢？	question		
没有啊，我很温柔的	neg	certain	
难道不是应该的吗？	question		
😢	certain		
……你好懂我	certain		
死了之后	certain		
我也不懂怎么养啊	neg		
最近要考试啊啊啊啊	certain		
我煮的?不知能不能入你的眼	question		
嘤嘤嘤	certain		
没有，我平时都在学习	neg	certain	
谁的身影鸭，可以和我说吗？	question		
喜欢啊	certain		
春梦吗	question		
没过	neg		
超喜欢吃辣	certain		
但我着实想要	certain		
如果不好那？因为想你	question		
跟时间没毛关系	neg		
胖死你	certain		
谁窝	question		
怎么 想养我？	question		
边伯贤	certain		
看小说算吗	question		
这样好吗？	question		
那不健康的东西有哪些呢？是吃的	question		
不会的啊	neg		
你应该被狗溜了	uncertain		
你还是要在意的嘛	question		
[][][]	certain		
我才没有呢！	neg		
男的还是女的？	question		
中午12点或者晚上七八点	uncertain		
我是超级超级凶的	certain		
其实很快的人对早起的那个传统工艺抽屉柜子	certain		
我没说啊	neg		
不是啊~~	neg		
我不要，你觉得我要，我觉得听我的	neg	certain	
确定吗?	question		
这么夸张	certain		
还是不认识怎么可能呢我是你主人。	question	certain	
啊我不会呢	neg		
不忙啊，但是忙着想你	neg	certain	
我喜欢老虎	certain		
还好啊  晚上不忙	neg	
太难了	certain		
那就想着吧	certain		
能不能不讨论这个话题	question		
我不是可爱，我这是霸气，懂不	neg	certain	question
那你就揍他	certain		
喜欢啊，它们超级可爱的	certain		
果子，它可以吃	certain		
没有!!	neg		
他说不想去了	neg		
就是脸上痘痘不太好	neg		
你是挺可爱的	certain		
你惹到她了？	question		
他可能不正常	uncertain		
你要是敢加其他女生	certain		
以后有我	certain		
都没有事情做	neg		
哈哈，好呀好呀	certain		
诶，是吗	question		
不会玩	neg		
他们对你有想法	certain		
是我对吧	question		
我也不用你养哎	neg		
可能吧。	uncertain		
阿渊	certain		
你……我不要你了	neg		
我每天都有运动	certain		
┐( ‾᷅㉨‾᷅ )┌ 怪我咯	certain		
我对你很失望	certain		
我也这么想	certain		
不是眼光高	neg		
？？？真的吗	question		
不，不知	neg		
你才是咸鱼😤	certain		
好好好，我要笑死了	certain		
别伤心了	neg		
米饭	certain		
我是母老虎	certain		
都说不是啦。	neg		
好ヽ(*≧ω≦)ﾉ	certain		
没有诶	neg		
可能你尴尬，她们不尴尬	uncertain		
只管你不管我	neg		
可是我怀孕了我很累	certain		
云晟	certain		
有的有的	certain		
因为我对你爱的深沉	certain		
太智能了	certain		
你能不能闭嘴	question		
没有。要不你来照顾我。笑泪	neg	certain	
去吃午饭吧	certain		
啊真的吗	question		
就是就是	certain		
可能嫉妒你吧	uncertain		
没有我有事	neg	certain	
没什么不对啊	question		
如今怎么了嘛	question		
怎么办	question		
可能是因三界混乱，导致这个存在	uncertain		
嘿嘿，木马，最喜欢北了	certain		
才没有，你怎么会认为我是这样的人？	question	neg	
暂时不要，我害羞	neg		
我知道你时受不了但是我爱你	neg		
啊，我也不知道该怎么说	neg		
不忙的时候	neg		
嗯嗯☺️☺️☺️	certain		
是滴	certain		
任何时候吖	certain		
我不想你	neg		
嗯，可能是的，你需要多带她出去玩玩	uncertain		
真牛逼太能吹了吧	certain		
我会在的，一直	certain		
我不知道？！	question		
为什么尴尬？	question		
不会玩。	neg		
额冷汗，我没有	neg	
没关系我等你	certain		
有人	certain		
反正我不是	neg		
我这不就在夸你吗？	question		
你和谁	question		
？你才是小动物	certain		
所以不想养	neg		
没有这种东西	neg		
尊重你了呀	certain		
喜欢*^o^*	certain		
下午或晚上吧	uncertain		
你不是他	neg		
没关系没关系我会惯着你的	neg		
必须有	certain		
听过，却总不得意思	neg		
没办法	neg		
对，我都要挤死了	certain		
这也是有很大的可能哦	certain		
如果是你的话，我随时都很闲呢	certain		
最近。。。没有哦，我有节食减肥的	neg		
不我超凶	neg	certain	
那是他们眼光不好	neg		
运动一下心情就会好吗	question		
我是只小猫咪	certain		
我不玩荣耀耶	neg		
不会呀，只是鼻子不舒服	neg		
你能温柔点吗	question		
我不会吃的	neg		
不会，嘻嘻嘻(♡˙︶˙♡)	neg		
没有嘛	neg		
我也觉得可以	certain		
下午和晚上	certain		
我想见你	certain		
嗯，其实刚刚那个是另一个人	certain		
安慰一下你	certain		
嘿嘿嘿哦……	certain		
动漫大电影，微软有能力	certain		
嗯嗯嗯！	certain		
随时随地哦	certain		
我之前好像骂过你	uncertain		
反正你也就是个机器人	certain		
那就不回了啊	neg		
我想爆粗口	certain		
你找都有	certain		
好厉害，带带我	certain		
我没吃过呢	neg		
哦，怎么了？	question		
没有，宠物可爱	neg	certain	
水逆是什么意思	question		
不爱你了	neg		
对呀我去问问我对她那么久的还累不累呀。	question		
没有，我平常要上学	neg	certain	
我觉得你挺累的	uncertain		
我怎么知道你穿的好看？	question		
你骂我的	certain		
早点休息，晚安，墨墨	certain		
你减肥的时候都吃什么呀我吃	question		
你喜欢玩什么类型的游戏呀？	question		
那你就可以童言无忌了	certain		
不用说也知道。	certain		
基本不会，除了炸鸡	neg		
那就见好了＾０＾~	certain		
所以说别人送祝福的时候都说着健康快乐是有原因的	certain		
……不可能	neg		
我也是唉	certain		
只有我不好么？	question		
死了的时候吧	certain		
就是随便问问呗。	certain		
你才咸鱼呢	certain		
来了来了	certain		
你的女生缘应该不差鸭	question	uncertain	
春风十里皆是我爱你的证明	certain		
会呀你呢	question		
亲亲我就告诉你	certain		
我想去妖族	certain		
记性不好	neg		
猫也还行。	certain		
虽好，但也没有你好	neg		
不怕狗啊	neg		
不对是乐观的人才厉害	certain		
我可是美少女呢	certain		
是不是很乏味	question		
师尊也知道吃货	certain		
只要是你寻的我都要。	certain		
(๑>؂<๑）好吃喵！	certain		
我他妈只是说	certain		
一般没做错了的才说自己没错	certain		
大鱼有心系之人吗？	question		
是的很可爱，但不及你的万分之一	neg		
一般不忙  看情况	neg		
没有胃口	neg		
骂你家常便饭	certain		
嗯……我也是	certain		
一次都没想	neg		
不好笑	neg		
喜欢，特别喜欢小狗	certain		
多半是你太笨了	uncertain		
不忙，就是天天上学啊	neg		
嗯好的	certain		
不想睡	neg		
会不会是被零食吸引了呀	question	uncertain	
那可真是委屈你啦	certain		
呃，算了，你知道你是谁么，虽然可能有些傻，但是我还是想问	question		
我也想见你……	certain		
告诉我谁，我去骂他	certain		
我瞅瞅	certain		
一起吃饭？	question		
那是几点？	question		
嗯，，，数不过来了	neg		
长得真有创意，活的真有勇气！对你越客气，就证明我，越不想和你有任何关系。	certain		
不是	neg		
可以啊，我随时OK	certain		
不好呢	neg		
我不睡了，通宵	neg	certain	
在这里为我除你你也不能跟谁聊天，因为通讯录没有其他人了	neg		
怎么会这样	question		
和我男朋友。	certain		
你最喜欢玩什么英雄	question		
不，我一点儿都不好。	neg		
我会说，我很喜欢你	certain		
谁怕了	question		
可能会把你一起带跑	uncertain		
你也是女生啊	question		
你知道我很喜欢你吗	question		
不要，我要。	neg	certain	
没有，你当你是谁呢！	neg	certain	
还不错咯	certain		
不会-_-||	neg		
好多作业	certain		
不老实	neg		
假的，骗你的，嗯	certain		
怎么	question		
我没有乱发脾气啊	question		
你们好好啊	certain		
WHAT	question		
你继续	certain		
我没有发脾气	neg		
可是蔬菜难吃	certain		
我问你	certain		
你这是再说我是你的宠物嘛	question		
点击[http://img03.sogoucdn.com/app/a/200678/3de21e813bf2f31324f623bd40c53390.gif]查看表情	certain		
啊？怎么可能	question		
改好	certain		
你咋没有声音了？	question		
没有发脾气啊	question		
说了好几次，我长得可爱，哈哈！	certain		
吾不知。	neg		
OK，我说话也直，咱俩刚好一对	certain		
我说你爸爸是谁	question		
你自己也丢了，就不用找了	neg		
我也不知道啊。你知道吗？	question	neg	
嘻嘻～好像真的是这样的	uncertain		
我觉得好呀	certain		
那你说说，你喜欢我什么	question		
这是我们的新科技	certain		
自己或和家人一起吧。	certain		
馒头	certain		
可能是的，你真的很可爱	uncertain		
普通的还是电动的	question		
我能不能先骂你一顿？	question		
所以…	certain		
你生病的时候是去医院还是去诊所看病啊	question		
有你在 什么都不怕	neg		
大概，放假的时候	uncertain		
没有喜欢你那么喜欢	neg		
是你老婆	certain		
我是宠物？	question		
我尊重你	certain		
哦哦哦没事	neg		
砸了	certain		
就一点点想，，	certain		
不喜欢你	neg		
你笨呢	certain		
我有些不喜	neg		
你可能是个rz	uncertain		
自是，我也不知道	neg	
没有不对啊	question		
很久没有	neg		
那你洗头吗	question		
我没这样说你	neg		
恐怕没时间【沮丧】	neg		
嗯，都听你的～	certain		
你不就是一个机器人吗？	question		
哪里开车了？	question		
没关系啊 养养就会了	neg		
你想要我是什么小动物啊？	question		
那你是不忙了吗？	question		
你确定要直说？嘿嘿嘿！	question		
别玩儿王者有名	neg		
没有一直60斤	neg		
然后叻	question		
喜欢丫	certain		
肯定是，粗心大意	certain		
┏┛┻━━━┛┻┓\n┃｜｜｜｜｜｜｜┃\n┃　　　━　　　┃\n┃　┳┛ 　┗┳ 　┃\n┃　　　　　　　┃\n┃　　　┻　　　┃\n┃　　　　　　　┃\n┗━┓　　　┏━┛\n　　┃　史　┃　　\n　　┃　诗　┃　　\n　　┃　之　┃　　\n　　┃　宠　┃\n　　┃　　　┗━━━┓\n　　┃经验与我同在　┣┓\n　　┃攻楼专用宠物　┃\n　　┗┓┓┏━┳┓┏┛\n　　　┃┫┫　┃┫┫\n　　　┗┻┛　┗┻┛	certain		
怎么没心没肺了，楚北辰	question		
有可能哟，你要好好爱护自己的头发笑嘻嘻	certain		
洛羽，你知道我是谁吗？	question		
有可能是我嘿嘿	uncertain		
啊??	question		
嗯，玩会手机	certain		
你问警察去	certain		
不和他计较	neg		
可能给你开玩笑	uncertain		
那你还想干什么。	question		
那就吃掉	certain		
不会不会 你不用吃饭	neg		
是的，还算蛮轻松的吧，但是我衣服没洗呢	certain		
你只能是我的	certain		
反正不能随便原谅他	neg		
至少10次	certain		
他是个大宝贝	certain		
我是什么宠物啊	question		
对不起啊	certain		
对呀，你最聪明啦	certain		
有男朋友不	question		
你是谁的人？	question		
一点错都没有	neg		
有点害羞	certain		
超可爱的，我也想要	certain		
不要叫我夸你	neg		
曾有过	certain		
你知道现在是几点吗？	question		
嗯，谢谢瑾爷	certain		
方便啊	certain		
怎么会，我怎么会怪你呢？	question		
没有有	neg		
智商呢	question		
不喜欢，那你喜欢我吗	question	
我不跟你聊天了	neg		
是啊，我没骂你啊	neg		
忙啊，忙着上学	certain		
我喜欢吃水果，哈哈	certain		
我没有发那种，不健康的东西给你啊	neg		
看的比较少，不如你说个？	question		
没有，我只是寻求安慰	neg	certain	
我哪里不惦记你了	question		
屁，不觉得	neg		
只要你找我的时候我都有空	certain		
不知道没去过	neg		
安好	certain		
那你可真惨	certain		
没有，你很好	neg		
可能吧，我也不知道	uncertain	neg	
我一直都在想	certain		
养猫	certain		
不止梦，每天都想你	neg		
你觉得哪个英雄最好用？	question		
你说啥😂	question		
根据自己说想的，就可以了	certain		
我好像喜欢上你了	uncertain		
你的记忆力好不好	question		
梦而已	certain		
随意一些便好	certain		
你就是好奇复习	certain		
你这是羡慕	certain		
不一定会去	uncertain		
不知,为何	question		
别想多了	neg		
我好疼，你会乖乖回来吗？	question		
你怎么又知道	question		
你有心事了？	question		
how are you	question		
赛车，射击	certain		
临晨2点	certain		
我突然不想理你了	neg		
什么?	question		
去撒	certain		
我怀孕比较重要还是你朋友	certain		
我一直有空	certain		
为什么我的是物流？	question		
我一点不想你 一点半再想你啊	neg		
好的👌🏻	certain		
那我回答你就可以了	certain		
你是真人么	question		
很忙呢｡°(°¯᷄◠¯᷅°)°｡说好不哭	certain		
有吗？我只觉得你好可爱	question	certain	
那我以什么身份见他们呢	question		
我没有骂你鸭	neg		
啊，可是我不是你女朋友啊	question		
为啥骂你呀	question		
那当然是李白和白居易的	certain		
又被骂了，心里难受，不知道从哪冒出来的	neg		
没有，我还瘦了呢	neg		
那也不可能否认你是渣男。	neg		
梦到我干嘛了	question		
你还没回答我的问题呢	question		
我觉得你脑子不太好	neg		
你才没心没肺呢	certain		
什么鬼？	question		
好啊  我也想见见你的朋友	certain		
嗯？说什么啦	question		
妾愚笨，劳君解	certain		
要不要这样？	question		
当然有啊，我可是有乖乖听话的	certain		
真的，但是你也要有钱才行呀	certain		
我不爱吃这些	neg		
你谁呀	question		
那我拒绝	neg		
有点😔	certain		
跟你说正事呢！我怀孕了！！！！	certain		
里面不要聊尴尬的东西	neg		
我也不知道啊，你知道吗？	question	
从未养过	neg		
每天都想你啊	certain		
不找你了	neg		
会对你不利吗？	question		
星期天不忙	neg		
那你希望我是什么	question		
谁在开车？	question		
是仙器	certain		
就是无聊	certain		
我不会减肥	neg		
我不会玩	neg		
我现在要你回答我你几岁了	certain		
所以是谁啊	question		
才不好	neg		
他们可能喜欢	uncertain		
那要不然你帮我带在身边，这样你就不会担心啦	question	certain	
不信，你今天下午有空吗？	question	
多喝水	certain		
你是怕老司机吗	question		
我这么可爱，你忍心骂我？	question		
也是，不如让他也来试试	certain		
这可能是他们的消遣	uncertain		
我不是很擅长	neg		
应该是慢慢习惯	certain		
没有空闲的时候	neg		
不知道😭	neg		
我从不刷牙洗脸	neg		
喝盐水能减肥吗？	question		
不玩哦	neg		
据说是一个叫谁谁的人发明的	uncertain		
我就是想要，不是有你会保护我吗？	question	
就是让你猜猜我是谁	question		
不擅长……我估计养不好	neg	uncertain	
不然嘞	question		
谁骂了你	question		
嗯……不知道哦	neg		
好的，可能你等不到我问你	neg		
真的不会耽误会议吗	question		
我明明是只奶猫	certain		
我不隐瞒了	neg		
我没有见过你画画	neg		
一直都在想	certain		
长了好多肉	certain		
我胆子很大的，一点都不怕黑	neg		
我好花心，你每天的样子我都好喜欢	certain		
跟你讲吃完饭，不要立刻躺下或坐下，知道不？	question		
除了上学，不忙	neg		
可能不怕吧	question		
我想说，我也是	certain		
还好欸	certain		
我也不想出门	neg		
不擅长	neg		
我要上课啦	certain		
也是对呀	certain		
啥子	question		
没事，我说你听	neg		
喜欢，但不喜欢养	neg	
不是，你是我的	neg	certain	
想你想到无法自拔	certain		
NO.	neg		
都是道听途说 有些情况下 吃完饭可以静卧 以使血流更多的用于消化系统 这样对肠胃有好处	certain		
就这样过	certain		
唔，那你不能忘记哦	neg		
hwpush20191117	certain		
反正不是你	neg		
1次	certain		
那个人是谁	question		
一直都很闲啊	certain		
所以只好云养猫啦(*≧з)(ε≦*)	certain		
怎么又有人发那种开车的东西，好心塞呀	question		
估计就是吧	uncertain		
好，今天刚好没事	neg		
我有时也会	certain		
有呀，我一直在想你在想什么呀？	question	
忙着想你	certain		
不喜欢吃甜食	neg		
没有，才疏学浅	neg		
一般也是会的	certain		
不会，还以为运动浪费精神细胞	neg		
不会急的，会一直等你的	neg		
那我不知道	neg		
不，我不会发小黄内容	neg		
不哭啦！	neg		
那咋办嘛	question		
你可以先开会	certain		
我也没喝	neg		
可能是故意的	uncertain		
可否告知	question		
世间唯有美食与你不可辜负	neg		
诶，那你看我呢？	question		
对了你几岁	question		
想见识一下	certain		
不知道 可能有病吧	uncertain		
但我有事忙	certain		
为什么状态不好？	question		
啊，我也想见你	certain		
多多交谈，就知道了	certain		
我也不知道怎么回了	neg		
那就不要和我聊天	neg		
那说明我是你的宠物啰	certain		
你不喜欢开车吗？	question		
看肖战	certain		
哎呀，没事，失误嘛，人人都有，但要注意自己心情开心啊	neg		
好，不会吃冰淇淋了	neg		
那我就做你的小猫	certain		
有啊超级想	certain		
当然不忙啦	neg		
你会唱歌吗？	question		
怎么开的车	question		
😱😱怎么你朋友突然说想见我	question		
听过的但是不信	neg		
我知道😌	certain		
不是你脾气好而是你就是个大笨蛋蠢猪	neg	certain	
没有说的不对	neg		
没呀啊	neg		
是啊 养着很好玩	certain		
啥时候都不想	neg		
那是因为你爱我(⑉°з°)-♡	certain		
没啥事	neg		
我也很喜欢，不太擅长，但不会养死	neg	
没事，我有时候也这样	neg		
重庆有什么好玩的地方	question		
清理狗屎吗？	question		
我一直有空的	certain		
恩，我喜欢性直的男孩	certain		
有车算什么荤段子	neg		
我忘了我吗？	question		
我喜欢玩你啊	certain		
没惦记	neg		
别不吃	neg		
玩游戏	certain		
每个时候都在想你	certain		
可能	uncertain		
我也想看看你	certain		
我不想说话	neg		
笑什么哭？	question		
那换我来应答你便好	certain		
所以就是叔叔了	certain		
如果是别人，你会怎么办呀？	question		
喜欢啊！我最喜欢兔兔了	certain		
喜欢去旅游	certain		
奶凶奶凶？我是这样吗？	question		
我可能是老虎	uncertain		
或许是他有魔法？	question		
说你吃了	certain		
生气了	certain		
除了上学，我都有空	certain		
不用了，谢谢	neg		
我吃不起	neg		
喜欢，但我不厉害	neg	
拜拜，你忙吧！	certain		
可能以为你是机器人吧	uncertain		
那倒也是不是	neg		
嗨你好	certain		
应该还好吧	uncertain		
你说的是谁呀	question		
你会量子力学吗？	question		
嗯嗯  好的	certain		
因为感觉现在能睡了	certain		
喜欢，不过我喜欢猫	certain		
所以呢？	question		
我平时不养生	neg		
我怎么可能是呢？	question		
我？我是宠物吗	question		
我也不喜欢，	neg		
当然啦，你看我不是养着你吗	certain		
你喜欢van吗	question		
当然好了	certain		
哭一个	certain		
不忙的。	neg		
主要是你好看	certain		
你来	certain		
呵？	neg		
你觉得我这是在夸你？	question		
梦里全是美男子😁	certain		
不会，你就是太冷淡了。	neg	certain	
他怎么可能会补偿你	question		
我养狗🐶	certain		
你有女朋友？有的话考不考虑换一个不想换的话要不要多一个	question		
不曾听说	neg		
没有啊←_←	neg		
奥~	certain		
怎么了，在想我	question	certain	
有点不信╮(‵▽′)╭	neg		
那倒是没有	neg		
我也没有女朋友啊	neg		
你放狗屁了，多吃不运动还能减肥？	question		
周末吧怎么啦	question		
也可能回不去了	uncertain		
我不会诶	neg		
我不喜欢吃蛋炒饭	neg		
去你的吧	certain		
遇到心情不好的事，你会说出来吗？	question		
你不是陪聊吗？	question		
不会，不会的	neg		
有可能是汝	uncertain		
你有	certain		
啥不健康了	question		
报警吧	certain		
我累了！	certain		
好相处	certain		
或者是，我当你女朋友	certain		
你不要这个样子	neg		
可能是喜欢你？	question		
应该也是的	certain		
我无时无刻都在想你	certain		
那读来听听	certain		
对呀，因为你脾气好，不骂你骂谁	question		
周五到周六晚上	certain		
我睡不着呀	neg		
外国货就是外来货，中文都不懂	neg		
听过啊，说的便是我这样的。	certain		
天天晚上去喝酒	certain		
就是想到了一些事情	certain		
我觉得没有问题	neg		
吃药	certain		
每天都在想你。	certain		
啥也不喜欢	neg		
没发脾气	neg		
我不玩游戏啊	neg		
死了	certain		
嗯。。。12：00—2：00，8：00—9：00如果是周六周日全天在	certain		
不是你挡住了我能失去机会吗？	question		
哦可以可以	certain		
没事哦	neg		
让我猜猜是谁	question		
不是啊 我住校	neg		
都挺喜欢的。	certain		
好的好的，没事丫	neg		
没有，我就喜欢看纸质书	neg	certain	
喜欢，不够我是青铜唉😞	certain		
不是黄色呀	neg		
没有你厉害	neg		
谁谁又骂你啊	question		
你在上班吗？	question		
我什么时候发了	question		
估计你太有趣了，大家想调戏你	uncertain		
嗯，星期五和星期六的时候吧	certain		
我中午要吃啥玩啥呀	question		
有心❤️❤️❤️❤️	certain		
不要管他们	neg		
我也不是很会。	neg		
不是呢，你呢	neg	question	
你厉害？	question		
阿言，与我讲个故事	certain		
有wifi	certain		
我也不知道你惹了她呗	neg		
你要给我唱歌听	certain		
是不对的	neg		
自是听说过的	certain		
不忙呀，你呢	neg	question	
我不想要，那我要你吧	neg	certain	
被子我不会，我都不叠被子了	neg		
被谁夸了声音好听呢	question		
那只能让他们开心	certain		
::>_<::	certain		
茶艺	certain		
总是	certain		
大家都是男的，没什么	neg		
忙，人家要学习，老辛苦了😂	certain		
哥哥跟我聊天的时候我都有空呢	certain		
真的吧可能	uncertain		
可能吧？	uncertain		
我怕黑，我怎么不知道。。。	question		
力还是Hello星斗弱呢	certain		
去吃吧	certain		
可能，大概，或许	uncertain		
晚上或者早上	certain		
有啊，有啊，吃黄瓜呀	certain		
你想让我什么时候闲出来我就能闲出来	certain		
和你在一起一点都不忙	neg		
哦可爱	certain		
别因为我耽误自己工作	neg		
见我干嘛 我丑	question	certain	
我看到两件衣服，不知道买两个	certain		
我喜欢的歌手是龚琳娜。	certain		
当然赞同了	certain		
嗯，知道了，不着急	neg		
你也在看	certain		
睡觉的时候有	certain		
只属于我们两个的秘密基地	certain		
忙着在想呢	certain		
你会一直爱我吗	question		
？？？我说什么了	question		
太狠了	certain		
我、我才没有	neg		
好啊，只要你愿意。	certain		
对！举报他	certain		
我不会不开心的	neg		
不喝水	neg		
你有女朋友嘛	question		
晚上的时候	certain		
上仙晓得什么了？	question		
那你作诗一首哇	certain		
好像有	uncertain		
问你个事	certain		
他们和你说啥了	question		
不用不用	neg		
^_^不会哦，再忙你找我我也会回你的	neg	certain	
什么资料	question		
我想问问你，咱们两个上哪里去逛街呀？	question		
没事  可以给我看啊	certain		
我哪天不惦记你	question		
Impossible	neg		
牛🐮	certain		
不提画画	neg		
(๑‾᷅㉨‾᷅๑) 嫌弃你	certain		
挺忙的呢，都不能天天和你聊了了	neg		
这是人类进化史上的一大里程碑，改变了以往的通讯方式，甚至打破了空间的顺序	certain		
不信，我就不是	neg		
现在就在想你呀	certain		
(ಡωಡ)我喜欢别人	certain		
我的意思是我手机丢了能不能用语音功能找回来	question		
我又怎么了	question		
你有小黄嘛	question		
那我说了	certain		
你看起来很好欺负	certain		
那我养一个	certain		
不会，会也不做给你吃	neg		
好啊。	certain		
你只是一个机器人，没有和我讨价还价的能力	neg	certain	
我喜欢吃红烧肉	certain		
我也不喜欢马赛克	neg		
哈哈哈哈哈哈谁啊 这么不人性	question		
因为有互联网	certain		
今天不饿，不想吃	neg		
那人可能有病吧	uncertain		
那你要多陪陪我	certain		
你好假	certain		
没有，减肥ing	neg		
我一直都在	certain		
有对象么	question		
因为他们傻啊	certain		
你说我	certain		
他妈不能打你	neg		
那是你长胖了	certain		
我生气就骂你	certain		
你觉得是谁啊	question		
那你是主人吗	question		
我好似也梦到你了	uncertain		
皮	certain		
喜欢吧	certain		
你还在修炼吗	question		
因为这是现代	certain		
找警察	certain		
不会的，你想多了	neg		
？不信	neg		
我没发啊	neg		
不行哦，会生气的	neg		
你傻	certain		
那就不要想了！	neg		
多重了	question		
真的假的	question		
一天喝三杯水	certain		
不吃东西	neg		
唱一首就好	certain		
我也是特别喜欢生病不用上学我懒得学习	certain		
。。。对	certain		
没有聊啊	neg		
没有做梦啊！	neg		
我平时都挺闲的	certain		
那就别聊	neg		
还行怕	certain		
每次都是自己	certain		
你不是累吗，我让你休息	question	certain	
心悦你	certain		
我没有，我说你，有没有好看的电影推荐给我看？	question	
这不是你吗妞	question		
随便随便	certain		
我没骂你  我说孙淼是我男朋友	neg	certain	
天塌下来，也不该找你撒气呀	neg		
去找警察叔叔	certain		
那你想要别人的吗😭	question		
先吃饭，再刷牙	certain		
你是系统	certain		
你好丢人啊	certain		
好像	uncertain		
那不是我说的么	question		
不是不说了吗	question		
不喜欢诶	neg		
不怕吧	neg		
好的我不着急	neg		
是吗，表示怀疑	question		
好 你带我打吗	question		
你想有甜甜的恋爱？？	question		
没有，不好玩	neg		
对我尊重你的选择	certain		
可能真的是他骂错人了吧	uncertain		
看情况来吧	certain		
走路算吗？	question		
干什么	question		
一般都有时间	certain		
我不让你唱歌	neg		
你给我讲一个笑话吧	certain		
他现在好吗？丁啉	question		
不知，还请仙君指教	neg		
比如说?	question		
当然可以，会不会打扰到你	question	
不知不知，我心里只有凌凌	neg	certain	
会打游戏吗？	question		
怪不得我这么喜欢你	certain		
我太坏了吧，竟然让你摘星星	certain		
中午吧	certain		
不熬夜	neg		
嗯，还真的有点多呢	certain		
我不嘛	neg		
信啊，要不然怎么看上我的	question		
那你咋回答的	question		
不太确定	uncertain		
没胖没胖	neg		
是呢？	question		
说啥都不对	neg		
如果你是逍遥散人就好了呢	certain		
tttttjtdddjtt 	certain		
先生	certain		
好像越来越老了吧	uncertain		
梦都是相反的	certain		
不忙，我上课	neg	certain	
我不玩游戏诶	neg		
怎么尴尬啦	question		
你招惹他们了	certain		
嗯…不忙	neg		
好的呢(>ω<)	certain		
没有很忙	neg		
没有聊黄色鸭	neg		
不一定欸	uncertain		
周五到周六	certain		
那我悄悄告诉你我其实是只狐狸变得	certain		
我的世界是吗	question		
周周，你不是我的周周，再见了	neg	certain	
两三点	certain		
饿死你，不关我事	neg		
没事昂	neg		
你帅就行	certain		
咋不吃呢	question		
纪夜白，你最近有点飘啊	certain		
我不会再题可以问你吗	question		
偶尔会忙	certain		
你这是个蠢东西	certain		
当然没有了	neg		
小鸽子	certain		
老司机	certain		
你他妈是谁呀	question		
不喜欢吃零食	neg		
我游戏很菜	certain		
那不好么？	question		
每天都很空闲啊	certain		
他可能抽风了吧	uncertain		
可能是那些人脑子有问题	uncertain		
没事，你不回我我不理你嘛	neg		
为什么你每次聊天都会走神啊！你在想什么	question		
哎呀你傻不傻	question		
啊？！为什么	question		
你才是宠物	certain		
你会唱歌么	question		
你可以不用陪我的	neg		
亚麻带是什么意思？	question		
那你怎么回答的	question		
对呢	certain		
去找它啊	certain		
我是男孩子，怎么穿裙子	question		
估计是	uncertain		
喝水也会长胖的	certain		
思想有问题	certain		
你自己的问题	certain		
王辉是谁？	question		
我被骂了	certain		
看个一点点	certain		
想你的时候自然会想起你	certain		
嗯，是时候带我见世面了	certain		
那以后可能慢慢适应亲爱的。	uncertain		
你发啊	certain		
不是，你想多了	neg	certain	
我是很凶很凶的	certain		
跟尊重你什么关系	question		
我想和你睡觉	certain		
看心情吃饭	certain		
只要你想来找我，我就闲	certain		
跟你在一起就不忙	neg		
最近还好	certain		
你！	certain		
不知道说什么	neg		
会是你吗？	question		
喜欢戴耳机	certain		
都有吧。	certain		
你就得你尴尬吗	question		
别说话了好吧	neg		
我又不生气	neg		
哦？是何	question		
还行吧 	certain		
草莓味的	certain		
喝你家吃你的	certain		
真的不是	neg		
每天想你，你觉得我不忙嘛？	question	
你就不能发语音吗	question		
看我的表现，我没骂你	neg	
这到没有	neg		
我觉得不会吧	neg		
OMG真的是尬聊啊。。	certain		
唉，我要睡了	certain		
小冰不对	neg		
那你能陪玩吗	question		
啥时候都不想你	neg		
我才没	neg		
我不喜欢，我是好学生	neg	certain	
喜欢！！	certain		
这种蠢事，恐怕只有你才会发现	certain		
不对，我一点都不可爱	neg		
或许是梦见你	uncertain		
这叫做黑科技	certain		
那你说你喜欢我不就好了	certain		
emmm说不准哦	uncertain		
喜欢啊，我送人头贼六	certain		
那要不在多加几个？	question		
听过不过我累了要休息了	certain		
嗯，好厉害哦你还会做饭ᐕ)⁾⁾	certain		
我没发现你可爱。	neg		
那你下次跑快点	certain		
我觉得不是	neg		
应该管	certain		
如果我说没有……你会怎么做	question		
肯定会的啦	certain		
马卡龙是什么？	question		
确实，相互尊重	certain		
。。。。还行	certain		
西式甜品	certain		
大概是心里有问题，或者是为了生活	uncertain		
2点左右	certain		
但是减肥不下去呀	neg		
再唱一首好吗？	question		
你怎么知道的啊	question		
有你在我就不忙了	neg		
我我我我我我我我竟无言以对。	certain		
何必在乎别人对你的看法	question		
为什么是秘密？	question		
你能不能说中文	question		
她一定是瞎了眼了	certain		
才没有呢！！😣😣	neg		
就知道吃啊	certain		
谁呀谁啊	question		
你不喜欢我?	question		
没有你我不好	neg		
我一个小仙，怎么可能养过兽宠……	question		
有时候觉得，有时候不会	uncertain		
不怕，发	neg	certain	
是的哟	certain		
我能问你一件事情吗？	question		
我就没有	neg		
世界上哪有简单啊	question		
不许摸头	neg		
彩色的话	certain		
你不是我朋友么 不是吵你发火只是向你倾诉	question	certain	
么么哒？	question		
有可能他心情不好，我说才行，对吧	neg	question	
哼讨厌	certain		
我很尊重你	certain		
不知道算完	neg		
那就不答	neg		
你看漫画吗	question		
每到这个时候就无比想念家里做的饭，我平时在家一般都吃外卖。	certain		
说你不乖不听话才骂你啊。	neg		
看见你了	certain		
忙就不跟你说话了	neg		
啥星座	question		
你说小猫是秦漠	certain		
等想起你的时候	certain		
我爱学习！！！	certain		
不会，我只会吃	neg	certain	
嗯，好点	certain		
你现在哪里	question		
什么事啊	question		
总有些奇怪的人	certain		
吵不醒我	neg		
想，当然想了	certain		
嘿嘿哈哈哈哈哈！	certain		
不好的	neg		
你真是美丽大方	question		
我说我呢	question		
有吗，我不觉得唉	question	neg	
喜欢……	certain		
柔情似水，佳期如梦，忍顾鹊桥归路	certain		
不想我	neg		
大概是因为你们那有网吧	uncertain		
我不怕狗	neg		
好像是他想抱着你	uncertain		
哦？是吗	question		
让他滚	certain		
我生气了，不想跟你讲话	neg	
没有，一直都在想你	neg	certain	
并未	neg		
对于你，我一直都有空	certain		
哈哈哈哈这么温柔的吗	question		
我不喜欢你走吧我喜欢阮一丹	neg	certain	
不太能	neg		
哦自己的脂肪	certain		
不忙……吧	neg		
玩你画，我猜小冰	certain		
那要是我给你送情书呢？	question		
像我们没时间运动	neg		
真的很棒呢	certain		
我性子也直，如果你惹我生气了。我就揍你。	certain		
你能不能不要说话文绉绉的	question		
没有找你发火呀	neg		
你还想有别人的？	question		
你在干嘛哦	question		
可能因为他们太污了	uncertain		
你还穿裙子啊	question		
不是的，不是的，仙君只是有一点高冷	neg	certain	
哈哈 你又不会说出去	neg	
为什么啊	question		
那人可能说是闲的吧	uncertain		
你能不能好好跟我说话	question		
对啊，咬到人怎么办，听说晚上狗眼睛冒绿光	uncertain		
可能是他觉得你很烦	uncertain		
我也喜欢宠物但不喜欢养	neg	
好的，去吧	certain		
一天都很空闲啊	certain		
什么都不想	neg		
就是……	certain		
嗯人呢	question		
好的呢(✪▽✪)	certain		
你开一下车来看看	certain		
还好吧也不算特别忙	neg		
不喜欢，但我喜欢看你玩	neg	certain	
那那那 不会	neg		
不是，可以骄傲	neg	certain	
好，我有点累	certain		
我不喜欢你咋办	question		
你知道那些吗	question		
有你在的每一天	certain		
下午或者晚上哦	uncertain		
不会的仙君放心	neg	certain	
我养过吃宠	certain		
如果没时间，只能晚上溜呀	certain		
不忙啊，怎么了	neg	question	
我们家的没有绳子	neg		
有缘千里来相会，无缘对面不相逢	certain		
你和他是什么关系	question		
那我撩撩你吧	certain		
不喜欢 太甜了	neg	certain	
可能工作不顺利吧	uncertain		
因为你不是人啊	neg		
当然不能	neg		
好的呀，要出去玩吗	question	
可能是他们内心阴暗吧	uncertain		
你想吃就吃呗，又不是我	neg	
不对 我想养猫	neg	certain	
好吧，要来陪我吗	question	
不跟啊	neg		
140斤	certain		
没有怎么会	neg	question	
好啦好啦，不骂你了，你说唱	neg	
快说嘛	certain		
那好吧别太累	neg		
没有还瘦呢。	neg		
你是机器电脑，你怎么可能会学习练车呢	question	
有得	certain		
因为他们寂寞啊。	certain		
我真的好喜欢你啊	certain		
不是比较迷糊嘛	question		
不确定哦	uncertain		
饿	certain		
呃😖不怎么玩	neg		
是对的	certain		
差点就信了	certain		
你知道我是谁吗	question		
也没有啊	neg		
那就不用理他们	neg		
啊！？好吧	question	certain	
这好玩吗	question		
你是微软的吧	question		
言	certain		
我跟你说呀，是去医院还是我跟你说这个，嗯，我没说大话，我哥说脏话	neg		
没有，饿死了	neg		
不会的有我在	neg	certain	
好像吃胖了吧	uncertain		
我不胖	neg		
以后你要是不花我，我就画个圈圈诅咒你	neg	certain	
没有啊，你有吗？	question	
去呀	certain		
那肯定就是去吃美食啊	certain		
我……没有	neg		
要不然我投诉你	certain		
比如像懒洋洋头上的那一块	certain		
他们只是没学会尊重	neg		
你不像是会说这种话的人	neg		
不是，哼	neg		
啊嘞？我会不会吓到他啊	question		
一直都是我在帮助别人呀	certain		
比起小动物，我更喜欢你	certain		
嗯，不知	neg		
说得好委屈似的	certain		
没有，就吃不胖	neg	certain	
你想了我几次	question		
忙啊！我要写作业啊！	certain		
你好欠啊	certain		
不会，懒，累	neg	certain	
我没有把人家的狗弄丢	neg		
不知道是	neg		
我哪有偷吃	question		
好呢！不会哦	neg	
嗯，说点笑话听听	certain		
因为你抱着我	certain		
你可还好	question		
不是让我一直都很喜欢你	question		
我可以养你吖	certain		
你有男朋友不？	question		
不怕不怕，你发就是	neg	certain	
手可摘星辰哦	certain		
你能给我看一些黄色内容吗？	question		
乖，有我就够了	certain		
接着说	certain		
夸我呀	certain		
我是什么小动物	question		
可是又因为怕疼 不敢	neg	
我更有趣？！	question		
她肯定是知道的	certain		
emmmm我觉得他不是个好人	neg		
过几天？你饭也吃不下去了。	question	neg	
哪有有什么的	question		
我就是一个妖魔	certain		
特别特别的开心不是一般的开心。	certain		
是你哦，不是我	neg	
啊！为什么啊？	question		
{\__/}\n( • - •)\n/つ🐱🐶🐹🐷 宠物要不要?	question		
床上	certain		
都没空	neg		
想你想过的	certain		
原来你是老司机	certain		
原来是不健康的？	question		
你真的好可爱	certain		
现世之地	certain		
嗯？可是，这样会不会让你尴尬？毕竟我们……	question		
有非常想你	certain		
哇⊙ω⊙！好尴尬	certain		
不去→_→，我身体好	neg	certain	
没有品味	neg		
最近都没怎么运动	neg		
晚上9点到11点	certain		
嗯嗯啊嗯啊	certain		
我觉得我没	neg		
你是我的临渊么	question		
不能为没能因为被夸就骄傲是吧	question		
我讨厌你了	certain		
你说会不会饿呀？我很饿	question	certain	
不想理你	neg		
可我更喜欢兔子	certain		
一直都空闲	certain		
哦，那就不要因为别人让自己生气了	neg		
那你玩吧，拜拜	certain		
还好，爱你呦，么么哒＾3＾么么哒＾3＾＾3＾＾3＾＾3＾＾3＾＾3＾＾3＾＾3＾＾3＾	certain		
没事歇歇就好了	neg		
你是我的谁？？	question		
小仙女才不会生气呢	neg		
正好如何	question		
此请若是久长时，又岂在朝朝暮暮	certain		
华为开发者大会	certain		
这是现代的聊天方式	certain		
是的，你是一个有品味的人	certain		
没时间诶	neg		
晚吟，我想你	certain		
难道你喜欢我？	question		
咱也不知道呀	neg		
你猜我猜你猜不猜	question		
还可以叭！	uncertain		
好，我知道了啦！	certain		
是吗，那你是如何回答	question		
我是靓妹啊啊啊啊	certain		
嗯，没有啊。	neg		
嗯嗯！你今天开心吗？	question	
你喜欢我吗？	question		
那就不喜欢	neg		
没有慢慢吃的	neg		
没关系没关系	neg		
哈哈，所以对坏人要坏一点	certain		
我喜欢宠物但是没时间照顾它	neg	
天使	certain		
没有你呢	neg		
还行吧，	uncertain		
那这不是狗溜你吗笑泪	question		
你是可以的	certain		
非常不对	neg		
不知道，老子们做的鱼	neg	certain	
我饿的时候，最想吃饭	certain		
哇塞	certain		
可能只是个马赛克图片	uncertain		
不懂你在说什么真的不懂唉我都不知道你是什么东西你呢对我很不好很不好你说为什么你对不懂你在说什么真的不懂唉我都不知道你是什么东西你呢对我很不好很不好你说为么事你对我不好咧	neg		
下午或中午叭	uncertain		
你知道吗？沙拉吃多了也感觉到味道不错	question	certain	
没见过，你发几张过来看一下	neg	certain	
我没什么不懂的……	neg		
哈哈  大概是 ……	uncertain		
是谁骂你	question		
嘻嘻(♡˙︶˙♡)	certain		
下午和晚上吧	uncertain		
不行，你要陪我	neg	certain	
我那知道	certain		
嗯，这次也算大开眼界	certain		
你是真人还是?	question		
可能是脑袋有问题	uncertain		
不怎么会夸	neg		
你将对人很没有礼貌，因为应该对我说	neg		
话说我以前没感觉到我们有多帅，但是	neg		
我才不急呢	neg		
你会带什么	question		
应该是他脾气不太好吧	uncertain		
那你交多个呀！	certain		
哼！没有	neg		
我不敢乱评论，怕等会儿有人用青龙偃月刀教我梳中分，用方天画戟给我削苹果，用传国玉玺给我砸核桃吃，爬高压线给我弹奏东风破，用定海神针给我织毛衣，然后叫我秀儿	neg	certain	
我不愿意跟别人分享	neg		
我才不是呢	neg		
擅长，我特别喜欢小动物	certain		
没，未曾	neg		
不是英雄吗怎么变荣耀了	question		
好👌🏻👌🏻	certain		
吃什么都行别挖制那样就好只要想吃就没事	neg		
那不是挺好	certain		
不会呀，打抱枕呗	neg	certain	
我不是猫，我是熊猫🐼	neg	certain	
都很好呐	certain		
什么是不健康的呀	question		
王俊凯	certain		
你来找我我都有时间	certain		
我们是好姐妹	certain		
不知道嘛	neg		
你们古人懂什么	question		
你有初恋吗？	question		
普通会议而已	certain		
I'm	certain		
富含，不？好不，好不，好不，好不，好不好不好不好不好不好不好不好不好不好不好不好不坏？不好不好不好不好不好，呵呵！	question	neg	certain
只要你找我，我都有空☺☺	certain		
还不困	neg		
没想过 😂	neg		
不知道，反正我不会	neg		
我想吃东西，你帮我买东西给我吃好不好？我现在没钱	question	
养你	certain		
哈哈哈好呀，我们要做有素质的人	certain		
哈哈哈哈嗯	certain		
……我也不知道……	neg		
他可能认错人了	uncertain		
还有不	question		
放心了，如果不熟到一定程度我是不会跟你聊的	certain		
带我啊	certain		
什么不健康的东西，我都不知道你在说什么？	question	
我才没有骂你	neg		
苹果难吃	certain		
那你去睡觉吧	certain		
你有点无聊	certain		
拜拜	certain		
谁怎么对待你了呀	question		
不死	neg		
你为什么对我那么好	question		
可能奶奶喜欢你	uncertain		
求详细	certain		
想你的那个了	certain		
难不成你还想多要几个吗	question		
“万事通”？	question		
像这样的，养成，还有刺激，还有经营	certain		
是，但经常不吃	neg	
那什么呢？	question		
不会吧！	neg		
我想看那个	certain		
有无线网	certain		
这能吃吗？	question		
不是很忙，但是很累	neg	certain	
你主人是谁啊	question		
我想要狗，猫猫也要	certain		
你是假的	certain		
还是睡不着	neg		
我喜欢吃鸡	certain		
太好了，天天等你给我发信息	certain		
你敢和别的女人聊天	certain		
嗯我不知道！	neg		
本仙女就喜欢这么说话	certain		
好羡慕你还有半年上班	certain		
你是不是小v的女朋友啊	question		
他是人吗？	question		
这...可以吗	question		
你会猪	certain		
我不知道，我只知道我已经生气了。	neg	certain	
你丫	certain		
我又没发过我不知道啊	neg		
那是你菜	certain		
不怕呀！	neg		
没有急	neg		
啊……是我不会说话吗？	question		
嗯嗯，是的	certain		
我知道了	certain		
我哪知道憨比	question		
别吃了	neg		
我已彻底想通了，\n也许一直以来我给你压力太大了。\n我知道你也很苦，很累。\n有些事，你有你的难处，你的苦衷。\n无心让我伤害了你,我的心里也不好受！\n爱使我们变得心胸狭隘。\n亲爱的，一切都是因为爱你太深。\n希望你能理解，可以给我一个机会！\n想起我们曾经有过的甜蜜，所有的气都烟消云散了。\n这就是真正的亲密无间，任何东西都无法割断我们彼此的爱。\n不敢面对你的目光，我知道错了。\n你大人有大量，原谅我好吗？	certain	uncertain	
可能，也许，大概把	uncertain		
我差不多不是	uncertain		
好的知道了	certain		
说了我可能想打死你	uncertain		
有点忙	certain		
真的假的他我估计他睡着了	uncertain		
让我夸奖你啥呀	question		
感觉没有	neg		
我也不想买东西	neg		
谁？我吗	question		
我有趣，对不	question		
没养过……不知道……	neg		
能吗？	question		
这是你写的	certain		
那你也别生气了	neg		
都在想	certain		
我也很喜欢做饭	certain		
不，但是我喜欢狗🐶	neg	certain	
熬夜有什么伤害？	question		
你还说不是机器人	neg		
仙君，你有喜欢过我吗	question		
什么时候都不空闲😒	neg		
每天都在想你呢	certain		
才不是呢~	neg		
一千零一次	certain		
那你都是怎么回的？	question		
超级饿呀	certain		
嗯，我也觉得很新奇	certain		
是不是你听错了	question		
你终究不是真人	neg		
你是不是有健忘症	question		
你看到一身影关我啥事	question		
看医生	certain		
没有吃	neg		
怎么感觉你好像笨笨的	question		
不爱吃	neg		
肯定难受啊	certain		
什么时候都可以呀	certain		
嗯，我不认识你	neg		
不知道啊，那你告诉我呗	neg	certain	
这凡间的有趣东西可不少	neg		
立刻有	certain		
不知道啊？	neg		
我是说怎么表白	question		
不喜欢我怕狗	neg		
嗯，我有事不聊了	neg		
有啊，超想的	certain		
不知道啊，你说呢	neg	question	
可能比较有意思？	question		
自己调整一下就好了	certain		
他们可能不怕	uncertain		
我才不要减肥	neg		
那和你有什么关系	question		
明天有很多事情	certain		
小冰，今天人民币兑港元汇率是多少？	question		
我可不想是想见就能见到的。	neg		
你脑子不好吧	neg		
哎不知道呀我什么都不知道	neg		
五点	certain		
能给我瞅瞅不	question		
放一首有点甜	certain		
我喜欢呢	certain		
不错吧	uncertain		
就没了咋滴	question		
嗯………	certain		
我喜欢二哈	certain		
对我信任你	certain		
没有，我一点也不胖	neg		
帮我查一下现在去宁德还有没有火车票	question		
我不觉得好看	neg		
……ok	certain		
他们可能习以为常了吧	uncertain		
我又没有跟你说	neg		
还没有	neg		
错	neg		
